12 16 10
################
#*             #
# ########## # #
# #          # #
# # ######## # #
# # #      # # #
# # #      # # #
# # ###### # # #
# #          # #
# ############ #
#              #
################