12 19 5
###################
########  #########
########  #########
########  #########
########  #########
#                 #
#   *             #
########  #########
########  #########
########  #########
########  #########
###################